100 100 100 100 100 100 100 100 100 100 100 100
010 000 000 000 000 000 000 100 100 100 100 100
100 100 100 100 100 100 000 100 100 100 100 100
100 100 100 100 100 100 000 100 100 100 100 100
100 100 100 100 100 100 000 000 000 000 000 001
100 100 100 100 100 100 100 100 100 100 100 100